co.opmart binh tan	Co.opMart BINH TAN
co.opmart binh tan 2	Co.opMart BINH TAN 2
co.opmart binh trieu	Co.opMart BINH TRIEU
co.opmart can gio	Co.opMart CAN GIO
co.opmart chu van an	Co.opMart CHU VAN AN
co.opmart cong quynh	Co.opMart CONG QUYNH
co.opmart cu chi	Co.opMart CU CHI
co.opmart do van day	Co.opMart DO VAN DAY
co.opmart dong van cong	Co.opMart DONG VAN CONG
co.opmart foodcosa	Co.opMart FOODCOSA
co.opmart hau giang	Co.opMart HAU GIANG
co.opmart hiep thanh	Co.opMart HIEP THANH
co.opmart hoa binh	Co.opMart HOA BINH
co.opmart hoc mon	Co.opMart HOC MON
co.opmart hung vuong	Co.opMart HUNG VUONG
co.opmart huynh tan phat	Co.opMart HUYNH TAN PHAT
co.opmart ly thuong kiet	Co.opMart LY THUONG KIET
co.opmart nguyen anh thu	Co.opMart NGUYEN ANH THU
co.opmart nguyen binh	Co.opMart NGUYEN BINH
co.opmart nguyen dinh chieu	Co.opMart NGUYEN DINH CHIEU
co.opmart nguyen kiem	Co.opMart NGUYEN KIEM
co.opmart nhieu loc	Co.opMart NHIEU LOC
co.opmart phan van hon	Co.opMart PHAN VAN HON
co.opmart phan van tri	Co.opMart PHAN VAN TRI
co.opmart phu lam	Co.opMart PHU LAM
co.opmart phu tho	Co.opMart PHU THO
co.opmart rach mieu	Co.opMart RACH MIEU
co.opmart sca au co	Co.opMart SCA AU CO
co.opmart sca cao thang	Co.opMart SCA CAO THANG
co.opmart sca hoang van thu	Co.opMart SCA HOANG VAN THU
co.opmart sca hoang van chieu	Co.opMart SCA HOANG VAN CHIEU
co.opmart tam binh	Co.opMart TAM BINH
co.opmart thang loi	Co.opMart THANG LOI
co.opmart to ky	Co.opMart TO KY
co.opmart tuy ly vuong	Co.opMart TUY LY VUONG
co.opmart van thanh	Co.opMart VAN THANH
co.opmart vinh loc b	Co.opMart VINH LOC B
co.opmart xa lo ha noi	Co.opMart XA LO HA NOI
co.opmart ba ria	Co.opMart BA RIA
co.opmart bien hoa	Co.opMart BIEN HOA
co.opmart binh duong	Co.opMart BINH DUONG
co.opmart binh duong 2	Co.opMart BINH DUONG 2
co.opmart chau thanh	Co.opMart CHAU THANH
co.opmart dong phu	Co.opMart DONG PHU
co.opmart dong xoai	Co.opMart DONG XOAI
co.opmart duong minh chau	Co.opMart DUONG MINH CHAU
co.opmart go dau	Co.opMart GO DAU
co.opmart phuoc dong	Co.opMart PHUOC DONG
co.opmart sca tay ninh	Co.opMart SCA TAY NINH
co.opmart tan bien	Co.opMart TAN BIEN
co.opmart tan an	Co.opMart TAN AN
co.opmart tan chau	Co.opMart TAN CHAU
co.opmart tan thanh	Co.opMart TAN THANH
co.opmart tay ninh	Co.opMart TAY NINH
co.opmart trang bang	Co.opMart TRANG BANG
co.opmart bac giang	Co.opMart BAC GIANG
co.opmart ha dong	Co.opMart HA DONG
co.opmart hai phong	Co.opMart HAI PHONG
co.opmart nam dinh	Co.opMart NAM DINH
co.opmart sai gon	Co.opMart SAI GON
co.opmart sca goldensilk	Co.opMart SCA GOLDENSILK
co.opmart sca goldsilk	Co.opMart SCA GOLDSILK
co.opmart sca long bien	Co.opMart SCA LONG BIEN
co.opmart sca victoria	Co.opMart SCA VICTORIA
co.opmart thanh hoa	Co.opMart THANH HOA
co.opmart viet tri	Co.opMart VIET TRI
co.opmart vinh phuc	Co.opMart VINH PHUC
co.opmart an nhon	Co.opMart AN NHON
co.opmart cam ranh	Co.opMart CAM RANH
co.opmart da nang	Co.opMart DA NANG
co.opmart dong ha	Co.opMart DONG HA
co.opmart duc pho	Co.opMart DUC PHO
co.opmart ha tinh	Co.opMart HA TINH
co.opmart hue	Co.opMart HUE
co.opmart lagi	Co.opMart LAGI
co.opmart nha trang	Co.opMart NHA TRANG
co.opmart phan ri cua	Co.opMart PHAN RI CUA
co.opmart phan thiet	Co.opMart PHAN THIET
co.opmart quang binh	Co.opMart QUANG BINH
co.opmart quang ngai	Co.opMart QUANG NGAI
co.opmart quy nhon	Co.opMart QUY NHON
co.opmart son tra	Co.opMart SON TRA
co.opmart tam ky	Co.opMart TAM KY
co.opmart thanh ha	Co.opMart THANH HA
co.opmart bac lieu	Co.opMart BAC LIEU
co.opmart ben luc	Co.opMart BEN LUC
co.opmart ben tre	Co.opMart BEN TRE
co.opmart binh thuy	Co.opMart BINH THUY
co.opmart ca mau	Co.opMart CA MAU
co.opmart cai lay	Co.opMart CAI LAY
co.opmart can giuoc	Co.opMart CAN GIUOC
co.opmart can tho	Co.opMart CAN THO
co.opmart cao lanh	Co.opMart CAO LANH
co.opmart chau doc	Co.opMart CHAU DOC
co.opmart duyen hai - tra vinh	Co.opMart DUYEN HAI - TRA VINH
co.opmart go cong	Co.opMart GO CONG
co.opmart ha tien	Co.opMart HA TIEN
co.opmart hong ngu	Co.opMart HONG NGU
co.opmart kien giang	Co.opMart KIEN GIANG
co.opmart kien giang 2	Co.opMart KIEN GIANG 2
co.opmart long an	Co.opMart LONG AN
co.opmart long xuyen	Co.opMart LONG XUYEN
co.opmart my tho	Co.opMart MY THO
co.opmart nga bay hau giang	Co.opMart NGA BAY HAU GIANG
co.opmart sa dec	Co.opMart SA DEC
co.opmart soc trang	Co.opMart SOC TRANG
co.opmart tan chau - an giang	Co.opMart TAN CHAU - AN GIANG
co.opmart thap muoi	Co.opMart THAP MUOI
co.opmart thoai son	Co.opMart THOAI SON
co.opmart thot not	Co.opMart THOT NOT
co.opmart tieu can	Co.opMart TIEU CAN
co.opmart tra vinh	Co.opMart TRA VINH
co.opmart bao loc	Co.opMart BAO LOC
co.opmart buon ho	Co.opMart BUON HO
co.opmart buon ma thuot	Co.opMart BUON MA THUOT
co.opmart chu se	Co.opMart CHU SE
co.opmart vinh long	Co.opMart VINH LONG
co.opmart cu m'gar	Co.opMart CU M'GAR
co.opmart dak nong	Co.opMart DAK NONG
co.opmart pleiku	Co.opMart PLEIKU
co.opmart kon tum	Co.opMart KON TUM
co.opmart tuy hoa	Co.opMart TUY HOA
co.opxtra tan phong	Co.opXtra TAN PHONG
co.opxtra linh trung	Co.opXtra LINH TRUNG
co.opxtra van hanh	Co.opXtra VAN HANH
co.opxtra pham van dong	Co.opXtra PHAM VAN DONG
co.opxtra tan phu	Co.opXtra TAN PHU
co.opxtra premium	Co.opXtra PREMIUM
