thế giới sữa gôi	THẾ GIỚI SỮA GÔI
thế giới sữa chợ chùa	THẾ GIỚI SỮA CHỢ CHÙA
thế giới sữa chợ cầu	THẾ GIỚI SỮA CHỢ CẦU
thế giới sữa chợ dần	THẾ GIỚI SỮA CHỢ DẦN
thế giới sữa cổ lễ	THẾ GIỚI SỮA CỔ LỄ
thế giới sữa chợ gạo	THẾ GIỚI SỮA CHỢ GẠO
thế giới sữa ngô đồng	THẾ GIỚI SỮA NGÔ ĐỒNG
thế giới sữa thịnh long	THẾ GIỚI SỮA THỊNH LONG
thế giới sữa giải phóng	THẾ GIỚI SỮA GIẢI PHÓNG
thế giới sữa đặng xuân bảng	THẾ GIỚI SỮA ĐẶNG XUÂN BẢNG
thế giới sữa hồng thuận	THẾ GIỚI SỮA HỒNG THUẬN
thế giới sữa quỹ nhất	THẾ GIỚI SỮA QUỸ NHẤT
thế giới sữa mai xá	THẾ GIỚI SỮA MAI XÁ
thế giới sữa yên chính	THẾ GIỚI SỮA YÊN CHÍNH
thế giới sữa bình lãng	THẾ GIỚI SỮA BÌNH LÃNG
thế giới sữa nghĩa tân	THẾ GIỚI SỮA NGHĨA TÂN
thế giới sữa quất lâm	THẾ GIỚI SỮA QUẤT LÂM
thế giới sữa hạ long	THẾ GIỚI SỮA HẠ LONG
thế giới sữa hành thiện	THẾ GIỚI SỮA HÀNH THIỆN
thế giới sữa nghĩa sơn	THẾ GIỚI SỮA NGHĨA SƠN
thế giới sữa hải phong	THẾ GIỚI SỮA HẢI PHONG
thế giới sữa hưng yên	THẾ GIỚI SỮA HƯNG YÊN
thế giới sữa trần nhật duật	THẾ GIỚI SỮA TRẦN NHẬT DUẬT
thế giới sữa trung đông	THẾ GIỚI SỮA TRUNG ĐÔNG
thế giới sữa chợ bể	THẾ GIỚI SỮA CHỢ BỂ
thế giới sữa trực đại	THẾ GIỚI SỮA TRỰC ĐẠI
thế giới sữa rạng đông	THẾ GIỚI SỮA RẠNG ĐÔNG
thế giới sữa giao tiến	THẾ GIỚI SỮA GIAO TIẾN
thế giới sữa xuân kiên	THẾ GIỚI SỮA XUÂN KIÊN
thế giới sữa bình mỹ	THẾ GIỚI SỮA BÌNH MỸ
thế giới sữa nguyễn văn trỗi	THẾ GIỚI SỮA NGUYỄN VĂN TRỖI
thế giới sữa duy tiên	THẾ GIỚI SỮA DUY TIÊN
thế giới sữa non	THẾ GIỚI SỮA NON
thế giới sữa chợ lương	THẾ GIỚI SỮA CHỢ LƯƠNG
thế giới sữa chợ đằn	THẾ GIỚI SỮA CHỢ ĐẰN
thế giới sữa phố cà	THẾ GIỚI SỮA PHỐ CÀ
thế giới sữa thanh hà	THẾ GIỚI SỮA THANH HÀ
thế giới sữa tt đồng văn	THẾ GIỚI SỮA TT ĐỒNG VĂN
thế giới sữa nhân hậu	THẾ GIỚI SỮA NHÂN HẬU
thế giới sữa đinh tiên hoàng	THẾ GIỚI SỮA ĐINH TIÊN HOÀNG
thế giới sữa đô hai	THẾ GIỚI SỮA ĐÔ HAI
thế giới sữa châu giang	THẾ GIỚI SỮA CHÂU GIANG
thế giới sữa bình nghĩa	THẾ GIỚI SỮA BÌNH NGHĨA
thế giới sữa kiện khê	THẾ GIỚI SỮA KIỆN KHÊ
thế giới sữa yên mô	THẾ GIỚI SỮA YÊN MÔ
thế giới sữa khánh phú	THẾ GIỚI SỮA KHÁNH PHÚ
thế giới sữa vân giang	THẾ GIỚI SỮA VÂN GIANG
thế giới sữa gia trấn	THẾ GIỚI SỮA GIA TRẤN
thế giới sữa trung sơn	THẾ GIỚI SỮA TRUNG SƠN
thế giới sữa đồng phong	THẾ GIỚI SỮA ĐỒNG PHONG
thế giới sữa vũ lạc	THẾ GIỚI SỮA VŨ LẠC
thế giới sữa diêm điền	THẾ GIỚI SỮA DIÊM ĐIỀN
thế giới sữa kiến xương	THẾ GIỚI SỮA KIẾN XƯƠNG
thế giới sữa quỳnh phụ	THẾ GIỚI SỮA QUỲNH PHỤ
thế giới sữa đông hưng	THẾ GIỚI SỮA ĐÔNG HƯNG
thế giới sữa long hưng	THẾ GIỚI SỮA LONG HƯNG
thế giới sữa mễ	THẾ GIỚI SỮA MỄ
thế giới sữa tiền hải	THẾ GIỚI SỮA TIỀN HẢI
thế giới sữa hưng nhân	THẾ GIỚI SỮA HƯNG NHÂN
thế giới sữa đông á	THẾ GIỚI SỮA ĐÔNG Á
thế giới sữa đông cơ	THẾ GIỚI SỮA ĐÔNG CƠ
thế giới sữa chợ thái	THẾ GIỚI SỮA CHỢ THÁI
thế giới sữa lý bôn	THẾ GIỚI SỮA LÝ BÔN
thế giới sữa chợ gốc	THẾ GIỚI SỮA CHỢ GỐC
thế giới sữa đống năm	THẾ GIỚI SỮA ĐỐNG NĂM
thế giới sữa nam trung	THẾ GIỚI SỮA NAM TRUNG
thế giới sữa chợ lục	THẾ GIỚI SỮA CHỢ LỤC
thế giới sữa thanh tân	THẾ GIỚI SỮA THANH TÂN
thế giới sữa tiên hưng	THẾ GIỚI SỮA TIÊN HƯNG
thế giới sữa chợ diêm	THẾ GIỚI SỮA CHỢ DIÊM
thế giới sữa lý thường kiệt	THẾ GIỚI SỮA LÝ THƯỜNG KIỆT
thế giới sữa thụy hà	THẾ GIỚI SỮA THỤY HÀ
thế giới sữa quỳnh hồng	THẾ GIỚI SỮA QUỲNH HỒNG
thế giới sữa tân phong	THẾ GIỚI SỮA TÂN PHONG
thế giới sữa an ninh	THẾ GIỚI SỮA AN NINH
thế giới sữa quỳnh nguyên	THẾ GIỚI SỮA QUỲNH NGUYÊN
thế giới sữa chợ lụ	THẾ GIỚI SỮA CHỢ LỤ
thế giới sữa an đồng	THẾ GIỚI SỮA AN ĐỒNG
thế giới sữa đồng bằng	THẾ GIỚI SỮA ĐỒNG BẰNG
thế giới sữa hùng dũng	THẾ GIỚI SỮA HÙNG DŨNG
thế giới sữa chợ cầu đen	THẾ GIỚI SỮA CHỢ CẦU ĐEN
thế giới sữa chợ buộm	THẾ GIỚI SỮA CHỢ BUỘM
thế giới sữa 264 lý bôn	THẾ GIỚI SỮA 264 LÝ BÔN
thế giới sữa quang trung	THẾ GIỚI SỮA QUANG TRUNG
thế giới sữa chợ tây	THẾ GIỚI SỮA CHỢ TÂY
thế giới sữa tây sơn	THẾ GIỚI SỮA TÂY SƠN
thế giới sữa hồng giang	THẾ GIỚI SỮA HỒNG GIANG
thế giới sữa tân an	THẾ GIỚI SỮA TÂN AN
thế giới sữa cầu gồ	THẾ GIỚI SỮA CẦU GỒ
thế giới sữa kim	THẾ GIỚI SỮA KIM
thế giới sữa đồi ngô	THẾ GIỚI SỮA ĐỒI NGÔ
thế giới sữa kép	THẾ GIỚI SỮA KÉP
thế giới sữa buộm	THẾ GIỚI SỮA BUỘM
thế giới sữa cao thượng	THẾ GIỚI SỮA CAO THƯỢNG
thế giới sữa neo	THẾ GIỚI SỮA NEO
thế giới sữa chũ	THẾ GIỚI SỮA CHŨ
thế giới sữa chàng	THẾ GIỚI SỮA CHÀNG
thế giới sữa tiền phong	THẾ GIỚI SỮA TIỀN PHONG
thế giới sữa bố hạ	THẾ GIỚI SỮA BỐ HẠ
thế giới sữa thị trấn thắng	THẾ GIỚI SỮA THỊ TRẤN THẮNG
thế giới sữa nhã nam	THẾ GIỚI SỮA NHÃ NAM
thế giới sữa nếnh	THẾ GIỚI SỮA NẾNH
thế giới sữa dĩnh kế	THẾ GIỚI SỮA DĨNH KẾ
thế giới sữa phố cốc	THẾ GIỚI SỮA PHỐ CỐC
thế giới sữa bích động	THẾ GIỚI SỮA BÍCH ĐỘNG
thế giới sữa hà vị	THẾ GIỚI SỮA HÀ VỊ
thế giới sữa ngọc sơn	THẾ GIỚI SỮA NGỌC SƠN
thế giới sữa gia sàng	THẾ GIỚI SỮA GIA SÀNG
thế giới sữa sông công	THẾ GIỚI SỮA SÔNG CÔNG
thế giới sữa ba hàng	THẾ GIỚI SỮA BA HÀNG
thế giới sữa hương sơn	THẾ GIỚI SỮA HƯƠNG SƠN
thế giới sữa phú lương	THẾ GIỚI SỮA PHÚ LƯƠNG
thế giới sữa chùa hang	THẾ GIỚI SỮA CHÙA HANG
thế giới sữa lương tài	THẾ GIỚI SỮA LƯƠNG TÀI
thế giới sữa gia đông	THẾ GIỚI SỮA GIA ĐÔNG
thế giới sữa từ sơn	THẾ GIỚI SỮA TỪ SƠN
thế giới sữa hồ	THẾ GIỚI SỮA HỒ
thế giới sữa đại bái	THẾ GIỚI SỮA ĐẠI BÁI
thế giới sữa chợ dâu	THẾ GIỚI SỮA CHỢ DÂU
thế giới sữa đại đồng	THẾ GIỚI SỮA ĐẠI ĐỒNG
thế giới sữa hương mạc 	THẾ GIỚI SỮA HƯƠNG MẠC
thế giới sữa yên phụ 	THẾ GIỚI SỮA YÊN PHỤ
thế giới sữa văn môn	THẾ GIỚI SỮA VĂN MÔN
thế giới sữa chợ sơn	THẾ GIỚI SỮA CHỢ SƠN
thế giới sữa đồng kỵ 	THẾ GIỚI SỮA ĐỒNG KỴ
thế giới sữa gia bình	THẾ GIỚI SỮA GIA BÌNH
thế giới sữa chợ ngụ 	THẾ GIỚI SỮA CHỢ NGỤ
thế giới sữa thanh khương	THẾ GIỚI SỮA THANH KHƯƠNG
thế giới sữa tân hồng	THẾ GIỚI SỮA TÂN HỒNG
thế giới sữa chờ	THẾ GIỚI SỮA CHỜ
thế giới sữa đại từ	THẾ GIỚI SỮA ĐẠI TỪ
thế giới sữa phố sàn	THẾ GIỚI SỮA PHỐ SÀN
thế giới sữa bắc lý	THẾ GIỚI SỮA BẮC LÝ
thế giới sữa tt vôi	THẾ GIỚI SỮA TT VÔI
thế giới sữa vĩnh hưng	THẾ GIỚI SỮA VĨNH HƯNG
thế giới sữa chợ bún	THẾ GIỚI SỮA CHỢ BÚN
thế giới sữa trường lâm 	THẾ GIỚI SỮA TRƯỜNG LÂM
thế giới sữa vác 	THẾ GIỚI SỮA VÁC
thế giới sữa vạn điểm 	THẾ GIỚI SỮA VẠN ĐIỂM
thế giới sữa phú la 	THẾ GIỚI SỮA PHÚ LA
thế giới sữa thạch bàn 	THẾ GIỚI SỮA THẠCH BÀN
thế giới sữa vân đình 	THẾ GIỚI SỮA VÂN ĐÌNH
thế giới sữa bình đà	THẾ GIỚI SỮA BÌNH ĐÀ
thế giới sữa xuân mai 	THẾ GIỚI SỮA XUÂN MAI
thế giới sữa ba thá	THẾ GIỚI SỮA BA THÁ
thế giới sữa trường yên 	THẾ GIỚI SỮA TRƯỜNG YÊN
thế giới sữa hoàng văn thụ	THẾ GIỚI SỮA HOÀNG VĂN THỤ
thế giới sữa thư phú	THẾ GIỚI SỮA THƯ PHÚ
thế giới sữa thạch hòa 	THẾ GIỚI SỮA THẠCH HÒA
thế giới sữa thắng lợi 	THẾ GIỚI SỮA THẮNG LỢI
thế giới sữa đại nghĩa	THẾ GIỚI SỮA ĐẠI NGHĨA
thế giới sữa cổ đông	THẾ GIỚI SỮA CỔ ĐÔNG
thế giới sữa quảng bị	THẾ GIỚI SỮA QUẢNG BỊ
thế giới sữa chùa thông	THẾ GIỚI SỮA CHÙA THÔNG
thế giới sữa phúc thọ	THẾ GIỚI SỮA PHÚC THỌ
thế giới sữa vật lại	THẾ GIỚI SỮA VẬT LẠI
thế giới sữa phú xuyên	THẾ GIỚI SỮA PHÚ XUYÊN
thế giới sữa cửu cao	THẾ GIỚI SỮA CỬU CAO
thế giới sữa lương bằng 	THẾ GIỚI SỮA LƯƠNG BẰNG
thế giới sữa phụng công	THẾ GIỚI SỮA PHỤNG CÔNG
thế giới sữa dân tiến	THẾ GIỚI SỮA DÂN TIẾN
thế giới sữa liêu xá	THẾ GIỚI SỮA LIÊU XÁ
thế giới sữa minh châu	THẾ GIỚI SỮA MINH CHÂU
thế giới sữa bô thời	THẾ GIỚI SỮA BÔ THỜI
thế giới sữa chợ đầu	THẾ GIỚI SỮA CHỢ ĐẦU
thế giới sữa tân việt	THẾ GIỚI SỮA TÂN VIỆT
thế giới sữa yên mỹ	THẾ GIỚI SỮA YÊN MỸ
thế giới sữa vĩnh quỳnh	THẾ GIỚI SỮA VĨNH QUỲNH
thế giới sữa hòa thạch	THẾ GIỚI SỮA HÒA THẠCH
thế giới sữa ngô xuân quảng	THẾ GIỚI SỮA NGÔ XUÂN QUẢNG
thế giới sữa bình phú	THẾ GIỚI SỮA BÌNH PHÚ
thế giới sữa liên quan	THẾ GIỚI SỮA LIÊN QUAN
thế giới sữa chúc sơn	THẾ GIỚI SỮA CHÚC SƠN
thế giới sữa thọ xuân	THẾ GIỚI SỮA THỌ XUÂN
thế giới sữa cát quế	THẾ GIỚI SỮA CÁT QUẾ
thế giới sữa hà huy tập	THẾ GIỚI SỮA HÀ HUY TẬP
thế giới sữa chợ bái	THẾ GIỚI SỮA CHỢ BÁI
thế giới sữa hòa nam	THẾ GIỚI SỮA HÒA NAM
thế giới sữa chu minh	THẾ GIỚI SỮA CHU MINH
thế giới sữa mỹ đình	THẾ GIỚI SỮA MỸ ĐÌNH
thế giới sữa kiến hưng	THẾ GIỚI SỮA KIẾN HƯNG
thế giới sữa thạch bích	THẾ GIỚI SỮA THẠCH BÍCH
thế giới sữa la phù	THẾ GIỚI SỮA LA PHÙ
thế giới sữa phố nỷ	THẾ GIỚI SỮA PHỐ NỶ
thế giới sữa phố keo	THẾ GIỚI SỮA PHỐ KEO
thế giới sữa kim nỗ	THẾ GIỚI SỮA KIM NỖ
thế giới sữa hoàng công chất	THẾ GIỚI SỮA HOÀNG CÔNG CHẤT
thế giới sữa trôi	THẾ GIỚI SỮA TRÔI
thế giới sữa phù lỗ	THẾ GIỚI SỮA PHÙ LỖ
thế giới sữa chợ tó	THẾ GIỚI SỮA CHỢ TÓ
thế giới sữa chợ yên	THẾ GIỚI SỮA CHỢ YÊN
thế giới sữa ngọc hồi	THẾ GIỚI SỮA NGỌC HỒI
thế giới sữa nhông	THẾ GIỚI SỮA NHÔNG
thế giới sữa tân hội	THẾ GIỚI SỮA TÂN HỘI
thế giới sữa hương sơn	THẾ GIỚI SỮA HƯƠNG SƠN
thế giới sữa sơn đồng	THẾ GIỚI SỮA SƠN ĐỒNG
thế giới sữa sóc sơn	THẾ GIỚI SỮA SÓC SƠN
thế giới sữa đại mỗ	THẾ GIỚI SỮA ĐẠI MỖ
thế giới sữa thạch đà	THẾ GIỚI SỮA THẠCH ĐÀ
thế giới sữa cổ nhuế	THẾ GIỚI SỮA CỔ NHUẾ
thế giới sữa nguyễn đức cảnh	THẾ GIỚI SỮA NGUYỄN ĐỨC CẢNH
thế giới sữa định công	THẾ GIỚI SỮA ĐỊNH CÔNG
thế giới sữa cổ bi	THẾ GIỚI SỮA CỔ BI
thế giới sữa yên sở	THẾ GIỚI SỮA YÊN SỞ
thế giới sữa tứ hiệp	THẾ GIỚI SỮA TỨ HIỆP
thế giới sữa xuân đỉnh	THẾ GIỚI SỮA XUÂN ĐỈNH
thế giới sữa định công 2	THẾ GIỚI SỮA ĐỊNH CÔNG 2
thế giới sữa lương sơn	THẾ GIỚI SỮA LƯƠNG SƠN
thế giới sữa hữu nghị	THẾ GIỚI SỮA HỮU NGHỊ
thế giới sữa tân giang 1	THẾ GIỚI SỮA TÂN GIANG 1
thế giới sữa kim bình	THẾ GIỚI SỮA KIM BÌNH
thế giới sữa cao phong	THẾ GIỚI SỮA CAO PHONG
thế giới sữa hàng trạm	THẾ GIỚI SỮA HÀNG TRẠM
thế giới sữa chăm mát	THẾ GIỚI SỮA CHĂM MÁT
thế giới sữa đồng tiến	THẾ GIỚI SỮA ĐỒNG TIẾN
thế giới sữa đà bắc	THẾ GIỚI SỮA ĐÀ BẮC
thế giới sữa tân lạc	THẾ GIỚI SỮA TÂN LẠC
thế giới sữa hải bối	THẾ GIỚI SỮA HẢI BỐI
thế giới sữa chợ mun	THẾ GIỚI SỮA CHỢ MUN
thế giới sữa chợ nghệ	THẾ GIỚI SỮA CHỢ NGHỆ
thế giới sữa kẻ vẽ	THẾ GIỚI SỮA KẺ VẼ
thế giới sữa chợ giường	THẾ GIỚI SỮA CHỢ GIƯỜNG
thế giới sữa vũ xuân thiều	THẾ GIỚI SỮA VŨ XUÂN THIỀU
thế giới sữa quốc oai	THẾ GIỚI SỮA QUỐC OAI
thế giới sữa tân mai	THẾ GIỚI SỮA TÂN MAI
thế giới sữa bạch đằng	THẾ GIỚI SỮA BẠCH ĐẰNG
thế giới sữa chợ chuông	THẾ GIỚI SỮA CHỢ CHUÔNG
thế giới sữa xốm	THẾ GIỚI SỮA XỐM
thế giới sữa tân khai	THẾ GIỚI SỮA TÂN KHAI
thế giới sữa yên phụ	THẾ GIỚI SỮA YÊN PHỤ
thế giới sữa đức giang	THẾ GIỚI SỮA ĐỨC GIANG
thế giới sữa trần cung	THẾ GIỚI SỮA TRẦN CUNG
thế giới sữa nam dư	THẾ GIỚI SỮA NAM DƯ
thế giới sữa khương trung	THẾ GIỚI SỮA KHƯƠNG TRUNG
thế giới sữa dùng 	THẾ GIỚI SỮA DÙNG
thế giới sữa bảo thành 	THẾ GIỚI SỮA BẢO THÀNH
thế giới sữa chợ cọi	THẾ GIỚI SỮA CHỢ CỌI
thế giới sữa đông sơn	THẾ GIỚI SỮA ĐÔNG SƠN
thế giới sữa hòa hiếu	THẾ GIỚI SỮA HÒA HIẾU
thế giới sữa chợ 1/5	THẾ GIỚI SỮA CHỢ 1/5
thế giới sữa chợ con cuông	THẾ GIỚI SỮA CHỢ CON CUÔNG
thế giới sữa chợ hôm	THẾ GIỚI SỮA CHỢ HÔM
thế giới sữa chợ rộc	THẾ GIỚI SỮA CHỢ RỘC
thế giới sữa mai trang	THẾ GIỚI SỮA MAI TRANG
thế giới sữa đô thành	THẾ GIỚI SỮA ĐÔ THÀNH
thế giới sữa đà sơn	THẾ GIỚI SỮA ĐÀ SƠN
thế giới sữa chợ tuần	THẾ GIỚI SỮA CHỢ TUẦN
thế giới sữa chợ anh sơn	THẾ GIỚI SỮA CHỢ ANH SƠN
thế giới sữa chợ dinh	THẾ GIỚI SỮA CHỢ DINH
thế giới sữa hợp tâm	THẾ GIỚI SỮA HỢP TÂM
thế giới sữa sa nam	THẾ GIỚI SỮA SA NAM
thế giới sữa trường tộ	THẾ GIỚI SỮA TRƯỜNG TỘ
thế giới sữa tuệ tĩnh	THẾ GIỚI SỮA TUỆ TĨNH
thế giới sữa cầu giát	THẾ GIỚI SỮA CẦU GIÁT
thế giới sữa trần hưng đạo	THẾ GIỚI SỮA TRẦN HƯNG ĐẠO
thế giới sữa nghi hải	THẾ GIỚI SỮA NGHI HẢI
thế giới sữa lê lợi	THẾ GIỚI SỮA LÊ LỢI
thế giới sữa phủ diễn	THẾ GIỚI SỮA PHỦ DIỄN
thế giới sữa tân kỳ	THẾ GIỚI SỮA TÂN KỲ
thế giới sữa diễn xuân	THẾ GIỚI SỮA DIỄN XUÂN
thế giới sữa diễn ngọc	THẾ GIỚI SỮA DIỄN NGỌC
thế giới sữa quán hành	THẾ GIỚI SỮA QUÁN HÀNH
thế giới sữa quán bánh	THẾ GIỚI SỮA QUÁN BÁNH
thế giới sữa hoàng mai	THẾ GIỚI SỮA HOÀNG MAI
thế giới sữa thanh chương	THẾ GIỚI SỮA THANH CHƯƠNG
thế giới sữa diễn hồng	THẾ GIỚI SỮA DIỄN HỒNG
thế giới sữa sơn hải	THẾ GIỚI SỮA SƠN HẢI
thế giới sữa diễn thọ	THẾ GIỚI SỮA DIỄN THỌ
thế giới sữa bến thủy	THẾ GIỚI SỮA BẾN THỦY
thế giới sữa yên thành	THẾ GIỚI SỮA YÊN THÀNH
thế giới sữa hậu thành	THẾ GIỚI SỮA HẬU THÀNH
thế giới sữa quỳnh nghĩa	THẾ GIỚI SỮA QUỲNH NGHĨA
thế giới sữa hợp thành	THẾ GIỚI SỮA HỢP THÀNH
thế giới sữa thanh giang	THẾ GIỚI SỮA THANH GIANG
thế giới sữa nghĩa sơn	THẾ GIỚI SỮA NGHĨA SƠN
thế giới sữa cay chanh	THẾ GIỚI SỮA CAY CHANH
thế giới sữa diễn mỹ	THẾ GIỚI SỮA DIỄN MỸ
thế giới sữa yên sơn	THẾ GIỚI SỮA YÊN SƠN
thế giới sữa tam quang	THẾ GIỚI SỮA TAM QUANG
thế giới sữa diễn kỷ	THẾ GIỚI SỮA DIỄN KỶ
thế giới sữa long xá	THẾ GIỚI SỮA LONG XÁ
thế giới sữa tân giang 	THẾ GIỚI SỮA TÂN GIANG
thế giới sữa nghi xuân	THẾ GIỚI SỮA NGHI XUÂN
thế giới sữa cẩm xuyên	THẾ GIỚI SỮA CẨM XUYÊN
thế giới sữa phố châu	THẾ GIỚI SỮA PHỐ CHÂU
thế giới sữa hương khê	THẾ GIỚI SỮA HƯƠNG KHÊ
thế giới sữa bắc hà	THẾ GIỚI SỮA BẮC HÀ
thế giới sữa xuân an	THẾ GIỚI SỮA XUÂN AN
thế giới sữa thạch hà	THẾ GIỚI SỮA THẠCH HÀ
thế giới sữa nghèn	THẾ GIỚI SỮA NGHÈN
thế giới sữa thạch châu	THẾ GIỚI SỮA THẠCH CHÂU
thế giới sữa thế giới sữa voi	THẾ GIỚI SỮA THẾ GIỚI SỮA VOI
thế giới sữa đức thọ	THẾ GIỚI SỮA ĐỨC THỌ
thế giới sữa thạch bằng	THẾ GIỚI SỮA THẠCH BẰNG
thế giới sữa cương gián	THẾ GIỚI SỮA CƯƠNG GIÁN
thế giới sữa hưng trí	THẾ GIỚI SỮA HƯNG TRÍ
thế giới sữa bỉm sơn	THẾ GIỚI SỮA BỈM SƠN
thế giới sữa nga sơn	THẾ GIỚI SỮA NGA SƠN
thế giới sữa bỉm sơn 2	THẾ GIỚI SỮA BỈM SƠN 2
thế giới sữa nga liên	THẾ GIỚI SỮA NGA LIÊN
thế giới sữa lang chánh	THẾ GIỚI SỮA LANG CHÁNH
thế giới sữa tân dân	THẾ GIỚI SỮA TÂN DÂN
thế giới sữa phố cát	THẾ GIỚI SỮA PHỐ CÁT
thế giới sữa vạn hà	THẾ GIỚI SỮA VẠN HÀ
thế giới sữa bút sơn	THẾ GIỚI SỮA BÚT SƠN
thế giới sữa quảng xương	THẾ GIỚI SỮA QUẢNG XƯƠNG
thế giới sữa hoằng ngọc	THẾ GIỚI SỮA HOẰNG NGỌC
thế giới sữa bến sung	THẾ GIỚI SỮA BẾN SUNG
thế giới sữa cành nàng	THẾ GIỚI SỮA CÀNH NÀNG
thế giới sữa yên cát	THẾ GIỚI SỮA YÊN CÁT
thế giới sữa cẩm thủy	THẾ GIỚI SỮA CẨM THỦY
thế giới sữa đò lèn	THẾ GIỚI SỮA ĐÒ LÈN
thế giới sữa chợ thiều	THẾ GIỚI SỮA CHỢ THIỀU
thế giới sữa quảng thắng	THẾ GIỚI SỮA QUẢNG THẮNG
thế giới sữa chợ bái thượng	THẾ GIỚI SỮA CHỢ BÁI THƯỢNG
thế giới sữa chợ đà	THẾ GIỚI SỮA CHỢ ĐÀ
thế giới sữa chợ phố cống	THẾ GIỚI SỮA CHỢ PHỐ CỐNG
thế giới sữa vĩnh thịnh	THẾ GIỚI SỮA VĨNH THỊNH
thế giới sữa tân an	THẾ GIỚI SỮA TÂN AN
thế giới sữa hậu lộc	THẾ GIỚI SỮA HẬU LỘC
thế giới sữa vĩnh lộc	THẾ GIỚI SỮA VĨNH LỘC
thế giới sữa minh lộc	THẾ GIỚI SỮA MINH LỘC
thế giới sữa nam giang	THẾ GIỚI SỮA NAM GIANG
thế giới sữa cầu quan	THẾ GIỚI SỮA CẦU QUAN
thế giới sữa ngọc lặc	THẾ GIỚI SỮA NGỌC LẶC
thế giới sữa thường xuân	THẾ GIỚI SỮA THƯỜNG XUÂN
thế giới sữa nga điền	THẾ GIỚI SỮA NGA ĐIỀN
thế giới sữa sầm sơn	THẾ GIỚI SỮA SẦM SƠN
thế giới sữa sao vàng	THẾ GIỚI SỮA SAO VÀNG
thế giới sữa nông cống	THẾ GIỚI SỮA NÔNG CỐNG
thế giới sữa ba chè	THẾ GIỚI SỮA BA CHÈ
thế giới sữa la hán	THẾ GIỚI SỮA LA HÁN
thế giới sữa chợ quăng	THẾ GIỚI SỮA CHỢ QUĂNG
thế giới sữa phố môi	THẾ GIỚI SỮA PHỐ MÔI
thế giới sữa bến ngự	THẾ GIỚI SỮA BẾN NGỰ
thế giới sữa quảng tiến	THẾ GIỚI SỮA QUẢNG TIẾN
thế giới sữa phú sơn	THẾ GIỚI SỮA PHÚ SƠN
thế giới sữa yên tâm	THẾ GIỚI SỮA YÊN TÂM
thế giới sữa quan hóa	THẾ GIỚI SỮA QUAN HÓA
thế giới sữa phố kiểu	THẾ GIỚI SỮA PHỐ KIỂU
thế giới sữa lam sơn	THẾ GIỚI SỮA LAM SƠN
thế giới sữa chợ sim	THẾ GIỚI SỮA CHỢ SIM
thế giới sữa đền lư	THẾ GIỚI SỮA ĐỀN LƯ
thế giới sữa vĩnh tường	THẾ GIỚI SỮA VĨNH TƯỜNG
thế giới sữa yên lạc	THẾ GIỚI SỮA YÊN LẠC
thế giới sữa hương canh 1	THẾ GIỚI SỮA HƯƠNG CANH 1
thế giới sữa tam dương	THẾ GIỚI SỮA TAM DƯƠNG
thế giới sữa lý thường kiệt	THẾ GIỚI SỮA LÝ THƯỜNG KIỆT
thế giới sữa chợ tổng	THẾ GIỚI SỮA CHỢ TỔNG
thế giới sữa lập thạch	THẾ GIỚI SỮA LẬP THẠCH
thế giới sữa hương canh 2	THẾ GIỚI SỮA HƯƠNG CANH 2
thế giới sữa phố kiệu	THẾ GIỚI SỮA PHỐ KIỆU
thế giới sữa tứ trưng	THẾ GIỚI SỮA TỨ TRƯNG
thế giới sữa tam hồng	THẾ GIỚI SỮA TAM HỒNG
thế giới sữa tam sơn	THẾ GIỚI SỮA TAM SƠN
thế giới sữa trung kiên	THẾ GIỚI SỮA TRUNG KIÊN
thế giới sữa quán tiên	THẾ GIỚI SỮA QUÁN TIÊN
thế giới sữa xuân hòa	THẾ GIỚI SỮA XUÂN HÒA
thế giới sữa trưng trắc	THẾ GIỚI SỮA TRƯNG TRẮC
thế giới sữa tích sơn	THẾ GIỚI SỮA TÍCH SƠN
thế giới sữa lập thạch 2	THẾ GIỚI SỮA LẬP THẠCH 2
thế giới sữa bãi bằng	THẾ GIỚI SỮA BÃI BẰNG
thế giới sữa thanh sơn	THẾ GIỚI SỮA THANH SƠN
thế giới sữa thanh ba	THẾ GIỚI SỮA THANH BA
thế giới sữa thanh thủy	THẾ GIỚI SỮA THANH THỦY
thế giới sữa nông trang	THẾ GIỚI SỮA NÔNG TRANG
thế giới sữa hùng sơn	THẾ GIỚI SỮA HÙNG SƠN
thế giới sữa yên lập 	THẾ GIỚI SỮA YÊN LẬP
thế giới sữa tây cốc 	THẾ GIỚI SỮA TÂY CỐC
thế giới sữa phú hộ	THẾ GIỚI SỮA PHÚ HỘ
thế giới sữa sông thao	THẾ GIỚI SỮA SÔNG THAO
thế giới sữa phương xá	THẾ GIỚI SỮA PHƯƠNG XÁ
thế giới sữa cổ tiết	THẾ GIỚI SỮA CỔ TIẾT
thế giới sữa đoan hùng	THẾ GIỚI SỮA ĐOAN HÙNG
thế giới sữa chí đám	THẾ GIỚI SỮA CHÍ ĐÁM
thế giới sữa hoàng xá	THẾ GIỚI SỮA HOÀNG XÁ
thế giới sữa thanh miếu	THẾ GIỚI SỮA THANH MIẾU
thế giới sữa phú lộc	THẾ GIỚI SỮA PHÚ LỘC
thế giới sữa châu phong	THẾ GIỚI SỮA CHÂU PHONG
thế giới sữa nguyễn du	THẾ GIỚI SỮA NGUYỄN DU
thế giới sữa hòa phong	THẾ GIỚI SỮA HÒA PHONG
thế giới sữa yển khê	THẾ GIỚI SỮA YỂN KHÊ
thế giới sữa trạm thản	THẾ GIỚI SỮA TRẠM THẢN
thế giới sữa phú lạc	THẾ GIỚI SỮA PHÚ LẠC
thế giới sữa tiên cát	THẾ GIỚI SỮA TIÊN CÁT
thế giới sữa hàn thuyên	THẾ GIỚI SỮA HÀN THUYÊN
thế giới sữa chân mộng	THẾ GIỚI SỮA CHÂN MỘNG
thế giới sữa tứ xã	THẾ GIỚI SỮA TỨ XÃ
thế giới sữa hùng lô	THẾ GIỚI SỮA HÙNG LÔ
thế giới sữa hùng vương	THẾ GIỚI SỮA HÙNG VƯƠNG
thế giới sữa thanh sơn 2	THẾ GIỚI SỮA THANH SƠN 2
thế giới sữa cổ tiết 2	THẾ GIỚI SỮA CỔ TIẾT 2
thế giới sữa yên ninh	THẾ GIỚI SỮA YÊN NINH
thế giới sữa yên bình	THẾ GIỚI SỮA YÊN BÌNH
thế giới sữa yên thịnh	THẾ GIỚI SỮA YÊN THỊNH
thế giới sữa chợ ga	THẾ GIỚI SỮA CHỢ GA
thế giới sữa cát lem	THẾ GIỚI SỮA CÁT LEM
thế giới sữa cổ phúc	THẾ GIỚI SỮA CỔ PHÚC
thế giới sữa minh tân	THẾ GIỚI SỮA MINH TÂN
thế giới sữa mậu a	THẾ GIỚI SỮA MẬU A
thế giới sữa thác bà	THẾ GIỚI SỮA THÁC BÀ
thế giới sữa sơn dương	THẾ GIỚI SỮA SƠN DƯƠNG
thế giới sữa tân bình	THẾ GIỚI SỮA TÂN BÌNH
thế giới sữa mỹ bằng	THẾ GIỚI SỮA MỸ BẰNG
thế giới sữa tân yên	THẾ GIỚI SỮA TÂN YÊN
thế giới sữa phan thiết	THẾ GIỚI SỮA PHAN THIẾT
thế giới sữa tân hà	THẾ GIỚI SỮA TÂN HÀ
thế giới sữa bảo hà	THẾ GIỚI SỮA BẢO HÀ
thế giới sữa hoàng liên	THẾ GIỚI SỮA HOÀNG LIÊN
thế giới sữa phố ràng	THẾ GIỚI SỮA PHỐ RÀNG
thế giới sữa cam đường	THẾ GIỚI SỮA CAM ĐƯỜNG
thế giới sữa hợp lý	THẾ GIỚI SỮA HỢP LÝ
thế giới sữa thái hòa	THẾ GIỚI SỮA THÁI HÒA
thế giới sữa việt quang	THẾ GIỚI SỮA VIỆT QUANG
thế giới sữa tân yên 2	THẾ GIỚI SỮA TÂN YÊN 2
thế giới sữa hưng hóa	THẾ GIỚI SỮA HƯNG HÓA
thế giới sữa vĩnh lộc	THẾ GIỚI SỮA VĨNH LỘC
thế giới sữa hiền đa	THẾ GIỚI SỮA HIỀN ĐA
thế giới sữa thanh ba 2	THẾ GIỚI SỮA THANH BA 2
thế giới sữa cốc lếu	THẾ GIỚI SỮA CỐC LẾU
thế giới sữa hùng sơn 2	THẾ GIỚI SỮA HÙNG SƠN 2
thế giới sữa kiến an 	THẾ GIỚI SỮA KIẾN AN
thế giới sữa vĩnh bảo 	THẾ GIỚI SỮA VĨNH BẢO
thế giới sữa thủy nguyên	THẾ GIỚI SỮA THỦY NGUYÊN
thế giới sữa minh kha	THẾ GIỚI SỮA MINH KHA
thế giới sữa trường sơn 	THẾ GIỚI SỮA TRƯỜNG SƠN
thế giới sữa chợ hương 	THẾ GIỚI SỮA CHỢ HƯƠNG
thế giới sữa tôn đức thắng	THẾ GIỚI SỮA TÔN ĐỨC THẮNG
thế giới sữa trần tất văn 	THẾ GIỚI SỮA TRẦN TẤT VĂN
thế giới sữa quý kim	THẾ GIỚI SỮA QUÝ KIM
thế giới sữa kiến thụy 	THẾ GIỚI SỮA KIẾN THỤY
thế giới sữa thiên hương 	THẾ GIỚI SỮA THIÊN HƯƠNG
thế giới sữa chợ lũng 	THẾ GIỚI SỮA CHỢ LŨNG
thế giới sữa trường chinh 	THẾ GIỚI SỮA TRƯỜNG CHINH
thế giới sữa tiên lãng 	THẾ GIỚI SỮA TIÊN LÃNG
thế giới sữa nguyễn lương bằng 	THẾ GIỚI SỮA NGUYỄN LƯƠNG BẰNG
thế giới sữa thiên lôi	THẾ GIỚI SỮA THIÊN LÔI
thế giới sữa chợ tổng	THẾ GIỚI SỮA CHỢ TỔNG
thế giới sữa thủy triều 	THẾ GIỚI SỮA THỦY TRIỀU
thế giới sữa lập lễ 	THẾ GIỚI SỮA LẬP LỄ
thế giới sữa bắc hưng 	THẾ GIỚI SỮA BẮC HƯNG
thế giới sữa đà nẵng	THẾ GIỚI SỮA ĐÀ NẴNG
thế giới sữa miếu hai xã 	THẾ GIỚI SỮA MIẾU HAI XÃ
thế giới sữa vĩnh niệm 	THẾ GIỚI SỮA VĨNH NIỆM
thế giới sữa tam cường 	THẾ GIỚI SỮA TAM CƯỜNG
thế giới sữa ngô gia tự 	THẾ GIỚI SỮA NGÔ GIA TỰ
thế giới sữa đông thái 	THẾ GIỚI SỮA ĐÔNG THÁI
thế giới sữa chợ rế 	THẾ GIỚI SỮA CHỢ RẾ
thế giới sữa chợ đôi 	THẾ GIỚI SỮA CHỢ ĐÔI
thế giới sữa mỹ đức 	THẾ GIỚI SỮA MỸ ĐỨC
thế giới sữa dư hàng	THẾ GIỚI SỮA DƯ HÀNG
thế giới sữa đa phúc	THẾ GIỚI SỮA ĐA PHÚC
thế giới sữa thanh lãng 	THẾ GIỚI SỮA THANH LÃNG
thế giới sữa thủy sơn 	THẾ GIỚI SỮA THỦY SƠN
thế giới sữa ninh giang 	THẾ GIỚI SỮA NINH GIANG
thế giới sữa quý cao 	THẾ GIỚI SỮA QUÝ CAO
thế giới sữa chợ rồng	THẾ GIỚI SỮA CHỢ RỒNG
thế giới sữa thanh miện 	THẾ GIỚI SỮA THANH MIỆN
thế giới sữa uông bí 	THẾ GIỚI SỮA UÔNG BÍ
thế giới sữa hà lầm	THẾ GIỚI SỮA HÀ LẦM
thế giới sữa mạo khê 	THẾ GIỚI SỮA MẠO KHÊ
thế giới sữa giếng đáy	THẾ GIỚI SỮA GIẾNG ĐÁY
thế giới sữa hồng hà 	THẾ GIỚI SỮA HỒNG HÀ
thế giới sữa an dương	THẾ GIỚI SỮA AN DƯƠNG
thế giới sữa chợ đôn 	THẾ GIỚI SỮA CHỢ ĐÔN
thế giới sữa đông hải	THẾ GIỚI SỮA ĐÔNG HẢI
thế giới sữa lê lai	THẾ GIỚI SỮA LÊ LAI
thế giới sữa chợ cột	THẾ GIỚI SỮA CHỢ CỘT
thế giới sữa trần hưng đạo	THẾ GIỚI SỮA TRẦN HƯNG ĐẠO
thế giới sữa chợ vàng	THẾ GIỚI SỮA CHỢ VÀNG
thế giới sữa hạ hòa	THẾ GIỚI SỮA HẠ HÒA
thế giới sữa lâm thao	THẾ GIỚI SỮA LÂM THAO
thế giới sữa đền hùng	THẾ GIỚI SỮA ĐỀN HÙNG
thế giới sữa âu cơ	THẾ GIỚI SỮA ÂU CƠ
thế giới sữa tiên kiên	THẾ GIỚI SỮA TIÊN KIÊN
thế giới sữa bình thuận	THẾ GIỚI SỮA BÌNH THUẬN
thế giới sữa na hang	THẾ GIỚI SỮA NA HANG
thế giới sữa hợp lý	THẾ GIỚI SỮA HỢP LÝ
thế giới sữa thái hòa	THẾ GIỚI SỮA THÁI HÒA
thế giới sữa thanh ba 2	THẾ GIỚI SỮA THANH BA 2
thế giới sữa hưng hóa	THẾ GIỚI SỮA HƯNG HÓA
thế giới sữa hiền đa	THẾ GIỚI SỮA HIỀN ĐA
thế giới sữa hùng sơn 2	THẾ GIỚI SỮA HÙNG SƠN 2
thế giới sữa bảo hà	THẾ GIỚI SỮA BẢO HÀ
thế giới sữa kim tân	THẾ GIỚI SỮA KIM TÂN
thế giới sữa quán toan 	THẾ GIỚI SỮA QUÁN TOAN
thế giới sữa cầu đen 	THẾ GIỚI SỮA CẦU ĐEN
thế giới sữa ngọ dương	THẾ GIỚI SỮA NGỌ DƯƠNG
thế giới sữa đình đông 	THẾ GIỚI SỮA ĐÌNH ĐÔNG
thế giới sữa đại hợp 	THẾ GIỚI SỮA ĐẠI HỢP
thế giới sữa tràng cát 	THẾ GIỚI SỮA TRÀNG CÁT
thế giới sữa hải triều 	THẾ GIỚI SỮA HẢI TRIỀU
thế giới sữa tứ kì 	THẾ GIỚI SỮA TỨ KÌ
thế giới sữa nam sách 	THẾ GIỚI SỮA NAM SÁCH
thế giới sữa hải thành	THẾ GIỚI SỮA HẢI THÀNH
thế giới sữa hạ long	THẾ GIỚI SỮA HẠ LONG
thế giới sữa chợ hàng	THẾ GIỚI SỮA CHỢ HÀNG
thế giới sữa anh sơn 2	THẾ GIỚI SỮA ANH SƠN 2
thế giới sữa xuân hòa	THẾ GIỚI SỮA XUÂN HÒA
thế giới sữa hàng tiện	THẾ GIỚI SỮA HÀNG TIỆN
thế giới sữa chợ đền	THẾ GIỚI SỮA CHỢ ĐỀN
thế giới sữa liễu đề	THẾ GIỚI SỮA LIỄU ĐỀ
thế giới sữa tt cồn	THẾ GIỚI SỮA TT CỒN
thế giới sữa tam thôn	THẾ GIỚI SỮA TAM THÔN
thế giới sữa cát thành	THẾ GIỚI SỮA CÁT THÀNH
thế giới sữa chợ hầu	THẾ GIỚI SỮA CHỢ HẦU
thế giới sữa yên đồng	THẾ GIỚI SỮA YÊN ĐỒNG
thế giới sữa hàng thao	THẾ GIỚI SỮA HÀNG THAO
thế giới sữa trần phú	THẾ GIỚI SỮA TRẦN PHÚ
thế giới sữa trực cường	THẾ GIỚI SỮA TRỰC CƯỜNG
thế giới sữa quế	THẾ GIỚI SỮA QUẾ
thế giới sữa vĩnh trụ	THẾ GIỚI SỮA VĨNH TRỤ
thế giới sữa vĩnh trụ 2	THẾ GIỚI SỮA VĨNH TRỤ 2
thế giới sữa hải thượng lãn ông	THẾ GIỚI SỮA HẢI THƯỢNG LÃN ÔNG
thế giới sữa nho quan	THẾ GIỚI SỮA NHO QUAN
thế giới sữa gia viễn	THẾ GIỚI SỮA GIA VIỄN
thế giới sữa bích đào	THẾ GIỚI SỮA BÍCH ĐÀO
thế giới sữa yên khánh	THẾ GIỚI SỮA YÊN KHÁNH
thế giới sữa chợ rịa	THẾ GIỚI SỮA CHỢ RỊA
thế giới sữa vũ thư	THẾ GIỚI SỮA VŨ THƯ
thế giới sữa nam hà	THẾ GIỚI SỮA NAM HÀ
thế giới sữa hưng hà	THẾ GIỚI SỮA HƯNG HÀ
thế giới sữa chợ bàng	THẾ GIỚI SỮA CHỢ BÀNG
thế giới sữa ý yên	THẾ GIỚI SỮA Ý YÊN
thế giới sữa chợ lâm	THẾ GIỚI SỮA CHỢ LÂM
thế giới sữa chợ quán	THẾ GIỚI SỮA CHỢ QUÁN
thế giới sữa tiền an	THẾ GIỚI SỮA TIỀN AN
thế giới sữa quảng ngọc	THẾ GIỚI SỮA QUẢNG NGỌC
thế giới sữa phố giắt	THẾ GIỚI SỮA PHỐ GIẮT
thế giới sữa xuân trung	THẾ GIỚI SỮA XUÂN TRUNG
thế giới sữa hòa bình	THẾ GIỚI SỮA HÒA BÌNH
thế giới sữa nguyễn trường tộ	THẾ GIỚI SỮA NGUYỄN TRƯỜNG TỘ
thế giới sữa tứ kỳ	THẾ GIỚI SỮA TỨ KỲ
