big c dong nai tet booth	BIG C Đồng Nai Tet Booth
big c mien dong tet booth	BIG C MIỀN ĐÔNG Tet Booth
big c truong chinh tet booth	BIGC TRƯỜNG CHINH Tet Booth
co.opmart thang loi tet booth	Co.opMart Thang Loi Tet Booth
co.opmart da nang tet booth	Co.opMart Da Nang Tet Booth
co.opmart xa lo ha noi tet booth	Co.opMart Xa Lo Ha Noi Tet Booth
co.opmart phan van tri tet booth	Co.opMart Phan Van Tri Tet Booth
coopmart ba ria tet booth	Coopmart Ba Ria Tet Booth
coopmart cao lanh tet booth	Coopmart Cao Lãnh Tet Booth
coopmart quang trung tet booth	Coopmart Quang Trung Tet Booth
coopmart phu tho tet booth	Coopmart Phú Thọ Tet Booth
COOPMART CỐNG QUỲNH TET BOOTH	COOPMART CỐNG QUỲNH TET BOOTH
go! my tho tet booth	GO! MỸ THO Tet Booth
go! nguyen thi thap tet booth	GO! NGUYỄN THỊ THẬP TET BOOTH
go! an lac tet booth	GO! AN LẠC Tet Booth
go! hue tet booth	GO! HUẾ Tet Booth
go! nha trang tet booth	GO! NHA TRANG Tet Booth
go! da nang tet booth	GO! Da Nang Tet Booth
trung tam mm mega an phu tet booth	TRUNG TAM MM MEGA MARKET AN PHU Tet Booth
megamarket can tho tet booth	MEGAMARKET CẦN THƠ TET BOOTH
trung tam mm mega market an phu tet booth	TRUNG TAM MM MEGA MARKET AN PHU Tet Booth
chi nhanh cong ty tnhh mm mega market (viet nam) tai thanh pho can tho tet booth	CHI NHANH CONG TY TNHH MM MEGA MARKET (VIET NAM) TAI THANH PHO CAN THO Tet Booth
lotte nam sai gon	LOTTE Nam Sài Gòn
lotte can tho	LOTTE CẦN THƠ
lotte nha trang	Lotte Nha Trang - Khánh Hòa
emart go vap	EMART Gò Vấp
emart sala	EMART SALA
